11111
1P0C1
10001
1E011
11111
